
@_@_@_@_@_@_@_@_@_@_@_@_@_@_@
@___________________________@
@________1_==>_LEVEL_1______@
@___________________________@
@________2_==>_LEVEL_2______@
@___________________________@
@________3_==>_STAR_WARS____@
@___________________________@
@________4_==>_BACK_________@
@___________________________@
@_@_@_@_@_@_@_@_@_@_@_@_@_@_@