_____#############_____
_____#...........#_____
######.#.#####.#.######
.......#.......#.......
###.####.#####.####.###
#$.....#...#...#.....$#
#.####.###.#.###.####.#
#....#___________#....#
####.###_##-##_###.####
...#.____#___#____.#...
##.#.###_#####_###.#.##
##.....#_______#.....##
##.#.#.#########.#.#.##
...#.#.....#.....#.#...
####.#####.#.#####.####
#.........._..........#
#.##.#############.##.#
#.##.#___________#.##.#
#$...#___________#...$#
######___________######